MP20,3,MP01,1,,,MP20
MP14,3,MP22,2,,,MP14
MP19,1,MP07,3,,,MP07
MP05,3,MP10,2,,,MP05
MP23,3,MP03,0,,,MP23
MP29,3,MP18,0,,,MP29
MP06,3,MP31,1,,,MP06
MP30,3,MP17,2,,,MP30
MP25,0,MP28,3,,,MP28
MP02,3,MP12,1,,,MP02
MP32,3,MP09,2,,,MP32
MP04,2,MP13,3,,,MP13
MP16,1,MP26,3,,,MP26
MP27,3,MP08,2,,,MP27
MP15,3,MP24,0,,,MP15
MP21,0,MP11,3,,,MP11
