MP01,1,1,1,1
MP02,1,1,1,1
MP03,1,1,1,1
MP04,1,1,1,1
MP05,1,1,1,1
MP06,1,1,1,1
MP07,1,1,1,1
MP08,1,1,1,1
MP09,1,1,1,1
MP10,1,1,1,1
MP11,1,1,1,1
MP12,1,1,1,1
MP13,1,1,1,1
MP14,1,1,1,1
MP15,1,1,1,1
MP16,1,1,1,1
MP17,1,1,1,1
MP18,1,1,1,1
MP19,1,1,1,1
MP20,1,1,1,1
MP21,1,1,1,1
MP22,1,1,1,1
MP23,1,1,1,1
MP24,1,1,1,1
MP25,1,1,1,1
MP26,1,1,1,1
MP27,1,1,1,1
MP28,1,1,1,1
MP29,1,1,1,1
MP30,1,1,1,1
MP31,1,1,1,1
MP32,1,1,1,1
