MP01,2,0,1,0
MP02,1,1,0,1
MP03,2,0,2,0
MP04,0,1,0,0
MP05,0,1,0,0
MP06,2,0,1,1
MP07,0,1,0,0
MP08,1,1,0,0
MP09,2,0,0,1
MP10,0,1,0,0
MP11,0,1,0,0
MP12,0,1,0,0
MP13,1,1,0,0
MP14,1,1,0,1
MP15,0,1,0,0
MP16,0,1,0,0
MP17,2,0,1,1
MP18,1,1,0,1
MP19,0,1,0,0
MP20,0,1,0,0
MP21,0,1,0,0
MP22,2,0,0,1
MP23,1,1,1,0
MP24,0,1,0,0
MP25,0,1,0,0
MP26,0,1,0,0
MP27,1,1,0,1
MP28,0,1,0,0
MP29,2,0,2,0
MP30,1,1,0,0
MP31,2,0,1,1
MP32,0,1,0,0
