FP01,0,0,0,0
FP02,0,0,0,0
FP03,0,0,0,0
FP04,0,0,0,0
FP05,0,0,0,0
FP06,0,0,0,0
FP07,0,0,0,0
FP08,0,0,0,0
FP09,0,0,0,0
FP10,0,0,0,0
FP11,0,0,0,0
FP12,0,0,0,0
FP13,0,0,0,0
FP14,0,0,0,0
FP15,0,0,0,0
FP16,0,0,0,0
FP17,0,0,0,0
FP18,0,0,0,0
FP19,0,0,0,0
FP20,0,0,0,0
FP21,0,0,0,0
FP22,0,0,0,0
FP23,0,0,0,0
FP24,0,0,0,0
FP25,0,0,0,0
FP26,0,0,0,0
FP27,0,0,0,0
FP28,0,0,0,0
FP29,0,0,0,0
FP30,0,0,0,0
FP31,0,0,0,0
FP32,0,0,0,0
