FP01,2,1,1,1
FP02,1,1,1,0
FP03,1,1,0,1
FP04,0,1,0,0
FP05,1,1,1,0
FP06,5,0,3,2
FP07,1,1,0,1
FP08,0,1,0,0
FP09,0,1,0,0
FP10,0,1,0,0
FP11,0,1,0,0
FP12,0,1,0,0
FP13,2,1,1,1
FP14,1,1,0,1
FP15,1,1,1,0
FP16,0,1,0,0
FP17,3,1,2,1
FP18,0,1,0,0
FP19,1,1,1,0
FP20,0,1,0,0
FP21,2,1,1,1
FP22,0,1,0,0
FP23,0,1,0,0
FP24,0,1,0,0
FP25,3,1,1,2
FP26,2,1,1,1
FP27,0,1,0,0
FP28,0,1,0,0
FP29,0,1,0,0
FP30,1,1,1,0
FP31,4,1,3,1
FP32,0,1,0,0
