MP01,0,0,0,0
MP02,0,0,0,0
MP03,0,0,0,0
MP04,0,0,0,0
MP05,0,0,0,0
MP06,0,0,0,0
MP07,0,0,0,0
MP08,0,0,0,0
MP09,0,0,0,0
MP10,0,0,0,0
MP11,0,0,0,0
MP12,0,0,0,0
MP13,0,0,0,0
MP14,0,0,0,0
MP15,0,0,0,0
MP16,0,0,0,0
MP17,0,0,0,0
MP18,0,0,0,0
MP19,0,0,0,0
MP20,0,0,0,0
MP21,0,0,0,0
MP22,0,0,0,0
MP23,0,0,0,0
MP24,0,0,0,0
MP25,0,0,0,0
MP26,0,0,0,0
MP27,0,0,0,0
MP28,0,0,0,0
MP29,0,0,0,0
MP30,0,0,0,0
MP31,0,0,0,0
MP32,0,0,0,0
