FP01,3,1,1,1
FP02,2,1,1,1
FP03,2,1,1,1
FP04,1,1,1,1
FP05,2,1,1,1
FP06,6,1,1,1
FP07,2,1,1,1
FP08,1,1,1,1
FP09,1,1,1,1
FP10,1,1,1,1
FP11,1,1,1,1
FP12,1,1,1,1
FP13,3,1,1,1
FP14,2,1,1,1
FP15,2,1,1,1
FP16,1,1,1,1
FP17,4,1,1,1
FP18,1,1,1,1
FP19,2,1,1,1
FP20,1,1,1,1
FP21,3,1,1,1
FP22,1,1,1,1
FP23,1,1,1,1
FP24,1,1,1,1
FP25,4,1,1,1
FP26,3,1,1,1
FP27,1,1,1,1
FP28,1,1,1,1
FP29,1,1,1,1
FP30,2,1,1,1
FP31,5,1,1,1
FP32,1,1,1,1
