FP01,4,4,2,2
FP02,7,3,4,3
FP03,3,4,0,3
FP04,4,4,0,4
FP05,1,4,1,0
FP06,9,4,6,3
FP07,4,4,1,3
FP08,3,4,0,3
FP09,0,4,0,0
FP10,0,4,0,0
FP11,4,4,2,2
FP12,1,4,1,0
FP13,5,4,2,3
FP14,4,4,1,3
FP15,5,3,4,1
FP16,1,4,0,1
FP17,7,4,5,2
FP18,4,4,3,1
FP19,7,4,5,2
FP20,3,4,2,1
FP21,7,4,3,4
FP22,2,4,2,0
FP23,2,4,2,0
FP24,1,4,1,0
FP25,3,4,3,0
FP26,7,3,6,1
FP27,4,4,1,3
FP28,2,4,1,1
FP29,1,4,0,1
FP30,6,3,2,4
FP31,6,4,3,3
FP32,7,4,3,4
