FP01,1,3,2,3
FP02,1,1,3,1
FP03,1,2,1,1
FP04,5,1,3,2
FP05,1,1,1,1
FP06,3,2,2,2
FP07,1,1,2,1
FP08,4,1,1,5
FP09,1,1,5,3
FP10,3,1,1,5
FP11,3,2,1,1
FP12,2,6,1,5
FP13,1,2,4,1
FP14,2,5,1,3
FP15,1,2,1,1
FP16,2,2,2,6
FP17,1,1,2,1
FP18,2,1,4,1
FP19,1,4,1,1
FP20,1,1,1,3
FP21,1,3,2,4
FP22,1,1,2,3
FP23,2,2,1,1
FP24,6,1,3,6
FP25,2,3,1,1
FP26,1,4,1,1
FP27,1,2,1,1
FP28,2,1,2,1
FP29,3,3,1,2
FP30,1,1,6,1
FP31,4,1,1,4
FP32,2,1,3,1
