MP01,2,1,2,1
MP02,1,3,1,3
MP03,1,1,2,1
MP04,4,2,2,5
MP05,5,2,1,3
MP06,1,3,2,1
MP07,2,1,2,6
MP08,1,1,1,1
MP09,4,5,1,2
MP10,1,1,1,1
MP11,1,1,1,2
MP12,1,6,2,4
MP13,2,2,2,1
MP14,6,1,5,1
MP15,1,4,1,1
MP16,1,1,1,2
MP17,2,1,1,1
MP18,1,2,3,2
MP19,3,1,6,2
MP20,1,1,1,1
MP21,3,2,3,3
MP22,1,1,3,4
MP23,1,3,4,1
MP24,1,2,4,1
MP25,2,2,1,1
MP26,3,2,1,2
MP27,2,1,1,1
MP28,1,1,2,3
MP29,1,1,1,2
MP30,2,4,1,2
MP31,3,1,1,1
MP32,2,3,3,1
