MP01,2,4,2,0
MP02,4,4,1,3
MP03,1,4,0,0
MP04,9,4,4,3
MP05,7,4,3,3
MP06,3,4,1,2
MP07,7,3,3,2
MP08,0,4,0,0
MP09,8,4,2,3
MP10,0,4,0,0
MP11,1,4,0,1
MP12,9,3,5,3
MP13,3,4,2,0
MP14,9,3,2,3
MP15,3,4,1,0
MP16,1,4,0,0
MP17,1,4,1,0
MP18,4,4,4,0
MP19,8,3,2,2
MP20,0,4,0,0
MP21,7,4,2,1
MP22,5,4,2,1
MP23,5,4,1,2
MP24,4,4,1,3
MP25,2,4,0,0
MP26,4,4,0,2
MP27,1,4,1,0
MP28,3,4,0,3
MP29,1,4,0,1
MP30,5,4,2,1
MP31,2,4,1,0
MP32,5,4,3,1
