FP01,3,1,3,0
FP02,2,2,1,1
FP03,0,3,0,0
FP04,1,2,1,0
FP05,3,2,0,3
FP06,1,2,1,0
FP07,1,3,0,1
FP08,0,3,0,0
FP09,2,1,0,2
FP10,2,1,0,2
FP11,2,2,1,1
FP12,2,2,1,1
FP13,2,1,1,1
FP14,1,2,1,0
FP15,5,1,4,1
FP16,1,2,1,0
FP17,3,1,2,1
FP18,3,2,0,3
FP19,1,2,1,0
FP20,2,3,2,0
FP21,1,2,1,0
FP22,0,3,0,0
FP23,1,2,0,1
FP24,4,3,3,1
FP25,2,3,1,1
FP26,1,2,0,1
FP27,3,1,2,1
FP28,2,2,2,0
FP29,0,3,0,0
FP30,4,2,2,2
FP31,6,1,4,2
FP32,2,1,1,1
