MP01,8,5,4,0
MP02,6,7,0,3
MP03,1,7,0,0
MP04,4,7,1,0
MP05,2,7,0,0
MP06,4,6,0,0
MP07,12,6,5,4
MP08,6,7,3,3
MP09,3,7,2,0
MP10,7,6,2,3
MP11,4,6,2,1
MP12,12,5,6,1
MP13,8,5,1,3
MP14,5,6,2,2
MP15,3,7,0,2
MP16,4,6,1,0
MP17,8,6,6,0
MP18,5,6,1,2
MP19,5,7,1,3
MP20,6,7,1,2
MP21,10,6,7,1
MP22,9,5,3,3
MP23,5,6,1,1
MP24,12,7,6,2
MP25,3,7,0,2
MP26,3,7,2,1
MP27,2,6,1,0
MP28,10,6,4,2
MP29,8,6,1,3
MP30,9,7,2,6
MP31,8,6,3,3
MP32,10,7,6,3
