MP01,8,6,4,0
MP02,7,7,1,3
MP03,1,8,0,0
MP04,5,7,1,0
MP05,2,8,0,0
MP06,5,6,1,0
MP07,13,6,5,4
MP08,7,7,3,3
MP09,4,7,2,0
MP10,7,7,2,3
MP11,4,7,2,1
MP12,12,6,6,1
MP13,9,5,1,4
MP14,6,6,2,2
MP15,3,8,0,2
MP16,4,7,1,0
MP17,8,7,6,0
MP18,6,6,1,2
MP19,5,8,1,3
MP20,6,8,1,2
MP21,10,7,7,1
MP22,9,6,3,3
MP23,6,6,1,1
MP24,13,7,6,3
MP25,4,7,1,2
MP26,4,7,3,1
MP27,3,6,1,0
MP28,10,7,4,2
MP29,8,7,1,3
MP30,9,8,2,6
MP31,9,6,4,3
MP32,11,7,6,3
